0000000000000000000000000100
0111000033000000000102200000
0111000003000000000000000100
0020000000000100000000000000
0000020000000000100001000000
0000000000222000000022200000
0000000000002000000000000000
0000000020000001100000000220
0000000000000000010000000000
0010000001000000000000000000
0020020011000022000000220000
0020020000100200000000000000
0020000000100000002222000000
0000000020000000000202000010
0000000202200000000022000000
0000010000000000100002000000
0000000000000000020000000000
0020000000000100000000000000
0000000000000000000000000200
0222000033000000000200000000
0222000003000000000000000200
