000000000000
011100003300
011100000300
002000000000
000002000000
000000000000
000000000000
000000002000
000000000000
001000000100
001002001100
001002000010
001000000010
000000002000
000000010110
